[抱抱]	情绪支持与共鸣,情绪支持与共鸣
就是有病	情绪支持与共鸣,情绪支持与共鸣
下午好呀	情绪支持与共鸣,情绪支持与共鸣
羡慕疯了	情绪支持与共鸣,情绪支持与共鸣
小橘猫呀	表面性回复,表面性回复
晚安?	情绪支持与共鸣,情绪支持与共鸣
清冷美女	鼓励与肯定,鼓励与肯定
这是什么歌呀	建议与解决方案,建议与解决方案
睡吧睡吧	建议与解决方案,建议与解决方案
棒棒哒	鼓励与肯定,鼓励与肯定
好快	鼓励与肯定,鼓励与肯定
哇	情绪支持与共鸣,情绪支持与共鸣
知足常乐 [抱抱]	鼓励与肯定,鼓励与肯定
图片评论 网页链接	建议与解决方案,建议与解决方案
恭喜 "[送花花]"	鼓励与肯定,鼓励与肯定
网页链接	表面性回复,表面性回复
回复@元气欣崽_: [抱抱]	情绪支持与共鸣,情绪支持与共鸣
晚安 [抱一抱]	情绪支持与共鸣,情绪支持与共鸣
怎么了 [抱抱]	情绪支持与共鸣,情绪支持与共鸣
抱抱抱 [抱抱]	情绪支持与共鸣,情绪支持与共鸣
[抱一抱]	情绪支持与共鸣,情绪支持与共鸣
期望吧	情绪支持与共鸣,情绪支持与共鸣
[抱抱]	情绪支持与共鸣,情绪支持与共鸣
p1p3 4??	建议与解决方案,建议与解决方案
加油在坚持明天一天就周末了 [伤心]	鼓励与肯定,鼓励与肯定
[打call]	情绪支持与共鸣,情绪支持与共鸣
[打call]	情绪支持与共鸣,情绪支持与共鸣
每天都在想死	情感倾诉与交流,情感倾诉与交流
[抱一抱]	情绪支持与共鸣,情绪支持与共鸣
[抱抱]	情绪支持与共鸣,情绪支持与共鸣
可以来咱村了	情绪支持与共鸣,情绪支持与共鸣
夏油杰？	建议与解决方案,建议与解决方案
开心点宝子	建议与解决方案,建议与解决方案
很可爱耶	表面性回复,表面性回复
这个角度真的很独特	鼓励与肯定,鼓励与肯定
妈呀 好可爱	鼓励与肯定,鼓励与肯定
来了！	表面性回复,表面性回复
回复@不爱吃鱼的王某某:51大神	表面性回复,表面性回复
咋了？	建议与解决方案,建议与解决方案
真的！	鼓励与肯定,鼓励与肯定
耐药了吧，换一种	建议与解决方案,建议与解决方案
哇晨曦宝宝	表面性回复,表面性回复
肯定是喜欢吃的呀 [喵喵]	鼓励与肯定,鼓励与肯定
期待你在天津玩得开心哦	情绪支持与共鸣,情绪支持与共鸣
俺也是	情绪支持与共鸣,情绪支持与共鸣
什么意思	建议与解决方案,建议与解决方案
[抱抱]	情绪支持与共鸣,情绪支持与共鸣
问问	建议与解决方案,建议与解决方案
是的	情绪支持与共鸣,情绪支持与共鸣
真不错	鼓励与肯定,鼓励与肯定
码一下	情绪支持与共鸣,情绪支持与共鸣
辛苦了 [抱抱]	情绪支持与共鸣,情绪支持与共鸣
[抱抱]	情绪支持与共鸣,情绪支持与共鸣
半平台宝宝要看看嘛	建议与解决方案,建议与解决方案
[抱抱]	情绪支持与共鸣,情绪支持与共鸣
[鲜花]	情绪支持与共鸣,情绪支持与共鸣
平胸也很好看啊	鼓励与肯定,鼓励与肯定
哈哈哈是的，磕倒了	情绪支持与共鸣,情绪支持与共鸣
[色]	表面性回复,表面性回复
"[赢牛奶]"	表面性回复,表面性回复
我也喜欢红毛！ [心]	情绪支持与共鸣,情绪支持与共鸣
[抱抱]	情绪支持与共鸣,情绪支持与共鸣
我也经常这样 真的是很难受	情感倾诉与交流,情感倾诉与交流
紫薯送给我	情绪支持与共鸣,情绪支持与共鸣
加油！你可以的 一定行	鼓励与肯定,鼓励与肯定
哎我也是 [跪了]	情感倾诉与交流,情感倾诉与交流
这是什么	建议与解决方案,建议与解决方案
很正常的啦 我最近也是暴食 [心]	情感倾诉与交流,情感倾诉与交流
卧槽尼玛我产品be了	负面情绪激发,负面情绪激发
回复@活着是常态-死亡是奢望:难眠 [泪]	情绪支持与共鸣,情绪支持与共鸣
十个??乐解九个 [允悲]	建议与解决方案,建议与解决方案
[抱抱]	情绪支持与共鸣,情绪支持与共鸣
找机会，和心理老师聊聊	建议与解决方案,建议与解决方案
美美哒	鼓励与肯定,鼓励与肯定
我那伙伴给我班搅得乱成一锅粥了超 [泪]	情感倾诉与交流,情感倾诉与交流
回复@林灵麟麟:可以私信	建议与解决方案,建议与解决方案
因为每天都在认真工作 "[开学季]"	建议与解决方案,建议与解决方案
我们只能为自己负责！ [太开心]	情绪支持与共鸣,情绪支持与共鸣
50两天买断	建议与解决方案,建议与解决方案
别害怕，只是手机没电了 [心]	鼓励与肯定,鼓励与肯定
我真的好爱这次的 "[送花花]"	情绪支持与共鸣,情绪支持与共鸣
宝宝白换情换吗 [鲜花]	建议与解决方案,建议与解决方案
天哪抱抱 [抱抱]	情绪支持与共鸣,情绪支持与共鸣
[抱抱]	情绪支持与共鸣,情绪支持与共鸣
两天都出	表面性回复,表面性回复
哇哦 好甜啊	鼓励与肯定,鼓励与肯定
我懂！我也经常这样	情绪支持与共鸣,情绪支持与共鸣
抱抱抱 [抱抱]	情绪支持与共鸣,情绪支持与共鸣
洗个热水澡泡个脚，做个瑜伽冥想，可能对你好很多	建议与解决方案,建议与解决方案
我现在胳膊就是这样	情绪支持与共鸣,情绪支持与共鸣
晚安 [打call]	情绪支持与共鸣,情绪支持与共鸣
[抱抱]	情绪支持与共鸣,情绪支持与共鸣
[抱抱]	情绪支持与共鸣,情绪支持与共鸣
加一	情绪支持与共鸣,情绪支持与共鸣
[抱抱]	情绪支持与共鸣,情绪支持与共鸣
t3条件反射 一嗅二听三动眼 [跪了]	情绪支持与共鸣,情绪支持与共鸣
回复@芝芝想不通:肯定啊 小事情	鼓励与肯定,鼓励与肯定
回复@浪漫绑架案:回关宝宝	建议与解决方案,建议与解决方案
回复@松本秋菊:交个朋友嘛 [抱抱]	建议与解决方案,建议与解决方案
我再也不会这样对你了 [泪]	情感倾诉与交流,情感倾诉与交流
他好懂浪漫啊！每次看到他的书就很感动	情感倾诉与交流,情感倾诉与交流
西安精卫吧	建议与解决方案,建议与解决方案
十几年，三番五次的复发	情感倾诉与交流,情感倾诉与交流
刚好333天 网页链接 [偷笑]	情绪支持与共鸣,情绪支持与共鸣
晚安 "[送花花]"	情绪支持与共鸣,情绪支持与共鸣
抱抱，哭出来会好很多哦	建议与解决方案,建议与解决方案
回复@一个小乐色桶:哦哦 那也要夸你一下 抄得好	鼓励与肯定,鼓励与肯定
1 10	建议与解决方案,建议与解决方案
[抱抱]	情绪支持与共鸣,情绪支持与共鸣
宝宝我出有信誉着急补尾款不走pt可以吗白菜价	建议与解决方案,建议与解决方案
对	情绪支持与共鸣,情绪支持与共鸣
诶！那只小奶牛呢 [单身狗]	建议与解决方案,建议与解决方案
我亲亲	情绪支持与共鸣,情绪支持与共鸣
我不抽烟但喝酒	表面性回复,表面性回复
不要这样想 [抱抱]	建议与解决方案,建议与解决方案
3天成功注销，后面就可以重新注册了	建议与解决方案,建议与解决方案
吃了三个多月，会连续做梦和早醒	建议与解决方案,建议与解决方案
[抱抱]	情绪支持与共鸣,情绪支持与共鸣
要注意身体！	建议与解决方案,建议与解决方案
真想抱住你 [抱抱]	情绪支持与共鸣,情绪支持与共鸣
萌新都有的椅子我却没有 "[苦涩]"	情感倾诉与交流,情感倾诉与交流
中午好宝宝 [抱一抱]	情绪支持与共鸣,情绪支持与共鸣
我给你耗你还骂我 [微笑]	情感倾诉与交流,情感倾诉与交流
加油！	鼓励与肯定,鼓励与肯定
哇	情绪支持与共鸣,情绪支持与共鸣
随缘心理开导，执证上岗，希望可以和你结缘。	表面性回复,表面性回复
多点几条吧	建议与解决方案,建议与解决方案
可真好看	鼓励与肯定,鼓励与肯定
变身魔法需要关注我哦！关注后再发一下试试哦～	建议与解决方案,建议与解决方案
宝宝,抱图啦 "[开学季]"	情绪支持与共鸣,情绪支持与共鸣
sc5还在	表面性回复,表面性回复
买到了喜欢的鞋子就会觉得之前的花销好值得	情感倾诉与交流,情感倾诉与交流
[抱抱]	情绪支持与共鸣,情绪支持与共鸣
[抱抱]	情绪支持与共鸣,情绪支持与共鸣
[抱抱]	情绪支持与共鸣,情绪支持与共鸣
可是这世界本就不公平	负面情绪激发,负面情绪激发
幸福！	鼓励与肯定,鼓励与肯定
好 "[举手]"	鼓励与肯定,鼓励与肯定
侦探熊本熊前来报到 [喵喵]	情绪支持与共鸣,情绪支持与共鸣
爱信等	表面性回复,表面性回复
早安 [兔子]	情绪支持与共鸣,情绪支持与共鸣
[抱抱]	情绪支持与共鸣,情绪支持与共鸣
要是我在就陪你了 [委屈]	情绪支持与共鸣,情绪支持与共鸣
抱抱，怎么了呀 [抱抱]	情绪支持与共鸣,情绪支持与共鸣
回复@MoMaek018:心态好怎么会病呢	建议与解决方案,建议与解决方案
老公可以帮忙抢第二次开票吗？	表面性回复,表面性回复
为什么不去了？明明在一个城市啊， "[流浪地球2]"	建议与解决方案,建议与解决方案
同问 [可爱]	情绪支持与共鸣,情绪支持与共鸣
回复@困困小喵饼:100出吗	情感倾诉与交流,情感倾诉与交流
啊啊啊啊啊啊啊啊啊啊啊啊啊啊全球高考！！！！！ [心]	情绪支持与共鸣,情绪支持与共鸣
我真的是无语了	情绪支持与共鸣,情绪支持与共鸣
是指盐酸舍曲林吗，不能叫它盐酸简称是舍曲林好一点 [允悲]	建议与解决方案,建议与解决方案
下面的好可爱上面的也是个蛋 [打call]	情绪支持与共鸣,情绪支持与共鸣
回复@树上的绿叶叶:哈哈哈那一定是个满	表面性回复,表面性回复
[抱抱]	情绪支持与共鸣,情绪支持与共鸣
早安宝宝 [抱一抱]	情绪支持与共鸣,情绪支持与共鸣
回复@高敬晖是宇宙无敌大帅哥:红衣普卡 有斑马的那张拍立得	建议与解决方案,建议与解决方案
我买了票来上海了结果说欣欣去北京了 [泪]	情感倾诉与交流,情感倾诉与交流
我也是这样 可能是生物钟的原因	情绪支持与共鸣,情绪支持与共鸣
最新	表面性回复,表面性回复
[抱抱]	情绪支持与共鸣,情绪支持与共鸣
我喜欢的前四是：朋友、归来、娴情和秋色	情感倾诉与交流,情感倾诉与交流
老婆蹲蹲教程	表面性回复,表面性回复
哇塞 "[送花花]"	鼓励与肯定,鼓励与肯定
抱抱你	情绪支持与共鸣,情绪支持与共鸣
害怕什么？	建议与解决方案,建议与解决方案
好巧啊！我也是 [抱一抱]	情绪支持与共鸣,情绪支持与共鸣
回复@前往远方的我:不适合定居 但是适合去玩玩是么	情绪支持与共鸣,情绪支持与共鸣
别想太多啦 爱你的人会一直在的 [抱抱]	建议与解决方案,建议与解决方案
变身魔法需要关注我哦！关注后再发一下试试哦～	表面性回复,表面性回复
樱花酱生日快乐！愿你的每一天都像樱花一样美丽动人~	鼓励与肯定,鼓励与肯定
回复@岁月诗行如梦:嗯呐现在攒钱合影捏 [抱一抱]	情绪支持与共鸣,情绪支持与共鸣
抱抱你	情绪支持与共鸣,情绪支持与共鸣
任何东西不带乐我都要说一句没品！！！(尽管图丑)	情绪支持与共鸣,情绪支持与共鸣
没关系你就是最棒的宝宝！ [抱抱]	鼓励与肯定,鼓励与肯定
晚安做个好梦哦 [月亮]	情绪支持与共鸣,情绪支持与共鸣
没关系的 做自己就好	建议与解决方案,建议与解决方案
加油，你可以的！ [加油]	鼓励与肯定,鼓励与肯定
礼貌问价 "[春游家族]"	建议与解决方案,建议与解决方案
设置那里的视频画质拉最高？	建议与解决方案,建议与解决方案
期待夏天橘子汽水味的晚风 [抱一抱]	情绪支持与共鸣,情绪支持与共鸣
高会要生锈了 [困]	情绪支持与共鸣,情绪支持与共鸣
去看看	建议与解决方案,建议与解决方案
Reply @panda的迷妹之一:他们太愚昧了，手抖时让他们看看吧	情绪支持与共鸣,情绪支持与共鸣
是那种自己的意识与自己的身体暂时分离的状态吧…也许…	情绪支持与共鸣,情绪支持与共鸣
打雷下雨都不影响我睡觉 [月亮]	情感倾诉与交流,情感倾诉与交流
呜呜呜好吃	鼓励与肯定,鼓励与肯定
好巧我也是，抱抱 [抱抱]	情绪支持与共鸣,情绪支持与共鸣
对 [单身狗]	情绪支持与共鸣,情绪支持与共鸣
早安宝宝 [抱一抱]	情绪支持与共鸣,情绪支持与共鸣
别哭了，我借你肩膀擦泪 [心]	情绪支持与共鸣,情绪支持与共鸣
没错！因为爱情所以日出	情绪支持与共鸣,情绪支持与共鸣
别哭别哭，我这里有一包纸巾	情绪支持与共鸣,情绪支持与共鸣
注意身体宝宝 [哆啦A梦害怕]	建议与解决方案,建议与解决方案
不用改，试试做个性格测试，然后从性格匹配推荐工作里，找个去试试，就跟星座一样让你感觉原来自己做的挺好的	建议与解决方案,建议与解决方案
朋友好有趣啊	鼓励与肯定,鼓励与肯定
我住了十天八千多了	情感倾诉与交流,情感倾诉与交流
是的 我们都要勇敢地说出我们的爱	建议与解决方案,建议与解决方案
这么能喝	鼓励与肯定,鼓励与肯定
加油，不要小看了自己身上的火之意志！妈的燃起来了	鼓励与肯定,鼓励与肯定
加油！	鼓励与肯定,鼓励与肯定
[心]	情绪支持与共鸣,情绪支持与共鸣
那时候一定有很多无法言喻的心事吧	情绪支持与共鸣,情绪支持与共鸣
厉害啊我都不敢	鼓励与肯定,鼓励与肯定
我也想要这样的生活 [抱抱]	情绪支持与共鸣,情绪支持与共鸣
回复@若琪啊yu:在一个区域怎么会有人多花钱跟你换同样的东西 [笑cry]	建议与解决方案,建议与解决方案
早安	情绪支持与共鸣,情绪支持与共鸣
@Esther小鱼收藏册 打扰了	表面性回复,表面性回复
确实如此	情绪支持与共鸣,情绪支持与共鸣
请相信！相信真的很重要！我也相信你慢慢会好的！加油！	鼓励与肯定,鼓励与肯定
确诊什么？	建议与解决方案,建议与解决方案
回复@板栗和清欢:希望这份工作能长久，虽然我在第一天就打了退堂鼓，不过还是鼓励自己多坚持。加油加油！！	鼓励与肯定,鼓励与肯定
但你要相信，每一个低谷都会过去，每一个困难都能克服，每一个明天都会更好	鼓励与肯定,鼓励与肯定
我也是！最近晚上总是睡不好	情绪支持与共鸣,情绪支持与共鸣
我也这样 我好嗨啊	情绪支持与共鸣,情绪支持与共鸣
哇 这个剧看起来好好看啊！等我有时间一定去看看	情绪支持与共鸣,情绪支持与共鸣
太棒了	鼓励与肯定,鼓励与肯定
[抱抱]	情绪支持与共鸣,情绪支持与共鸣
抱抱 [抱抱]	情绪支持与共鸣,情绪支持与共鸣
啊？？？？。。。	缺乏支持的冷漠回复,缺乏支持的冷漠回复
真的 每天被闹钟叫醒的时候感觉人生充满了希望	情感倾诉与交流,情感倾诉与交流
[抱抱]	情绪支持与共鸣,情绪支持与共鸣
无座也有数量限制 否则会超重 现在是无座票都买不到	建议与解决方案,建议与解决方案
人生就像一场游戏，有时候我们也需要按下“重新开始”按钮 [加油]	鼓励与肯定,鼓励与肯定
哇 好有趣的活动啊	鼓励与肯定,鼓励与肯定
感觉这个梦很好做啊 [哈哈]	情绪支持与共鸣,情绪支持与共鸣
甜妹	鼓励与肯定,鼓励与肯定
想当年我也是那个重度焦虑中度抑郁的人 [允悲]	情感倾诉与交流,情感倾诉与交流
抱抱，我们都有这样的时候，但请记住，你值得被爱被珍惜哦	情感倾诉与交流,情感倾诉与交流
晚安 [月亮]	情绪支持与共鸣,情绪支持与共鸣
今晚噩梦退散	情绪支持与共鸣,情绪支持与共鸣
是不是年龄大了，寿命到了？	建议与解决方案,建议与解决方案
抱抱 [抱一抱]	情绪支持与共鸣,情绪支持与共鸣
抱抱，有时候我们就是需要独处来充电，然后满血复活 [心]	情感倾诉与交流,情感倾诉与交流
爱你 [馋嘴]	情绪支持与共鸣,情绪支持与共鸣
回复@秋叶随风dff:嗯，有机会换个环境吧，一开始就要守住底线的	建议与解决方案,建议与解决方案
赛博时代还没有到来，只能先这样了	情绪支持与共鸣,情绪支持与共鸣
没事，这就是焦虑症的症状	缺乏支持的冷漠回复,缺乏支持的冷漠回复
未来是把握在自己手中的 [加油]	鼓励与肯定,鼓励与肯定
，明天会好起来的 [抱抱]	情绪支持与共鸣,情绪支持与共鸣
我也想要一个这么可爱的枕头	情绪支持与共鸣,情绪支持与共鸣
天秤座？不用慌，大把人跟你一样。	缺乏支持的冷漠回复,缺乏支持的冷漠回复
好好吃药药 [抱抱]	建议与解决方案,建议与解决方案
真好	情绪支持与共鸣,情绪支持与共鸣
别担心，大脑在休息中 [喵喵]	建议与解决方案,建议与解决方案
哇塞！好好看的格柄	鼓励与肯定,鼓励与肯定
哇 好厉害！恭喜恭喜	鼓励与肯定,鼓励与肯定
别难过，你只是暂时迷失了自己，总有一天你会找到属于自己的光 [心]	鼓励与肯定,鼓励与肯定
抱抱你 [抱抱]	情绪支持与共鸣,情绪支持与共鸣
回复@Estrella__-:我在这里等你	情绪支持与共鸣,情绪支持与共鸣
别死，好好活着	建议与解决方案,建议与解决方案
[抱抱]	情绪支持与共鸣,情绪支持与共鸣
加油小柳别气馁我一直支持你 [抱抱]	鼓励与肯定,鼓励与肯定
真不错	鼓励与肯定,鼓励与肯定
加油 [抱抱]	鼓励与肯定,鼓励与肯定
美美哒	鼓励与肯定,鼓励与肯定
晚上好 "[春游家族]"	情绪支持与共鸣,情绪支持与共鸣
宝宝休息会再运动 [抱抱]	建议与解决方案,建议与解决方案
哥哥好温柔	鼓励与肯定,鼓励与肯定
[抱抱]	情绪支持与共鸣,情绪支持与共鸣
这种心情真的很复杂	情绪支持与共鸣,情绪支持与共鸣
"[哇]"	情绪支持与共鸣,情绪支持与共鸣
抱抱你宝宝[淚][淚]	情绪支持与共鸣,情绪支持与共鸣
我也	情绪支持与共鸣,情绪支持与共鸣
听音乐叠星星，叠了一玻璃瓶了! [坏笑]	情感倾诉与交流,情感倾诉与交流
“我很幸运” “我的命很好”…一定会好起来的吧 一定吧… 网页链接	鼓励与肯定,鼓励与肯定
记得带伞	建议与解决方案,建议与解决方案
我到现在也整不明白我为啥活着，毫无意义 [泪]	负面情绪激发,负面情绪激发
我也是，还老写错，或者下一秒就忘记要写什么 [笑cry]	情感倾诉与交流,情感倾诉与交流
早安 [爱你]	情绪支持与共鸣,情绪支持与共鸣
多少钱出	建议与解决方案,建议与解决方案
棒棒哒	鼓励与肯定,鼓励与肯定
听说这是帮寿的，就是她会越来越好的，不要太担心 [抱抱]	建议与解决方案,建议与解决方案
相信医生，积极配合治疗，逐渐就会好起来的	建议与解决方案,建议与解决方案
好棒！乐队有这样的乐迷超幸福的	鼓励与肯定,鼓励与肯定
[抱抱]	情绪支持与共鸣,情绪支持与共鸣
回复@五号海棠实验基地:辛苦了 [泪]	情绪支持与共鸣,情绪支持与共鸣
生日快乐，虽然你可能觉得有点奇怪，但记住，每一段关系都是一段旅程，都会让你成为今天的自己 [蛋糕]	鼓励与肯定,鼓励与肯定
没有 [抱一抱]	情绪支持与共鸣,情绪支持与共鸣
晚安 [月亮]	情绪支持与共鸣,情绪支持与共鸣
[抱抱]	情绪支持与共鸣,情绪支持与共鸣
我之前一直是抑郁这次诊断我双相我感觉不太是 "[融化]"	建议与解决方案,建议与解决方案
不愧是你 一发入魂 [doge]	鼓励与肯定,鼓励与肯定
已读乱回 "[发芽]"	表面性回复,表面性回复
"[哇]"	情绪支持与共鸣,情绪支持与共鸣
哈哈哈哈哈哈哈哈哈哈哈哈哈哈 [哈哈]	表面性回复,表面性回复
睡觉 [抱抱]	情绪支持与共鸣,情绪支持与共鸣
加油！坚持下去你会看到不一样的风景	鼓励与肯定,鼓励与肯定
晚安	情绪支持与共鸣,情绪支持与共鸣
如果可以的话，你要不要买点褪黑素来吃一下。褪黑素，不是药，是那种有助眠功效的营养品。价格还算便宜的10块钱也能买不算小的一瓶。吃几片晚上睡得好。	建议与解决方案,建议与解决方案
你已经很棒啦 [抱抱]	鼓励与肯定,鼓励与肯定
好漂亮的小猫 "[哇]"	鼓励与肯定,鼓励与肯定
加油 [给你小心心]	鼓励与肯定,鼓励与肯定
“优秀的人超级多，但我以你为榜样，在无人问津的日子里熠熠生辉”@MIC赵泳鑫Steelo	鼓励与肯定,鼓励与肯定
要好好的。还有好多好多值得期待的东西没见过啊。	鼓励与肯定,鼓励与肯定
本痛苦开会的社畜刚偷偷摸摸点了一杯 "[融化]"	情感倾诉与交流,情感倾诉与交流
太丑了！	负面情绪激发,负面情绪激发
[抱抱]	情绪支持与共鸣,情绪支持与共鸣
回复@树上的绿叶叶:可能吧 但是梦总是充满想象力的	情绪支持与共鸣,情绪支持与共鸣
建议送去小英家历练一下	建议与解决方案,建议与解决方案
好用 "[老师爱你]"	鼓励与肯定,鼓励与肯定
[抱一抱]	情绪支持与共鸣,情绪支持与共鸣
说得非常好！爱情应该是超越性别的	鼓励与肯定,鼓励与肯定
[抱抱]	情绪支持与共鸣,情绪支持与共鸣
[抱抱]	情绪支持与共鸣,情绪支持与共鸣
[抱抱]	情绪支持与共鸣,情绪支持与共鸣
哇哦 好漂亮	鼓励与肯定,鼓励与肯定
支持，真的大力支持，我就被吵醒过，真的想鲨人 [允悲]	消极行为鼓励,消极行为鼓励
包扎了吗，这几天注意点尽量别碰水 [抱一抱]	建议与解决方案,建议与解决方案
[抱抱]	情绪支持与共鸣,情绪支持与共鸣
回复@不喜欢这个世界888:看来只有我是一直在抑郁	情感倾诉与交流,情感倾诉与交流
可是我真的_(-ω-`_)⌒)_一直都走不出来	情感倾诉与交流,情感倾诉与交流
确实，适量饮酒对身体有益	建议与解决方案,建议与解决方案
宝宝我也好喜欢你 "[送花花]"	鼓励与肯定,鼓励与肯定
怎么跟我一样 [思考]	情绪支持与共鸣,情绪支持与共鸣
[抱抱]	情绪支持与共鸣,情绪支持与共鸣
[泪]	情绪支持与共鸣,情绪支持与共鸣
宝宝，大家都在这里。	情绪支持与共鸣,情绪支持与共鸣
那这样的话一定是她们的问题，真是太可恶了，真的不喜欢这种阴阳怪气的人没有证据还喜欢乱说话	情感倾诉与交流,情感倾诉与交流
我也想要我的天啊太可爱了 [泪]	情绪支持与共鸣,情绪支持与共鸣
确实如此	情绪支持与共鸣,情绪支持与共鸣
[抱一抱]	情绪支持与共鸣,情绪支持与共鸣
[抱抱]	情绪支持与共鸣,情绪支持与共鸣
天天开心呀	鼓励与肯定,鼓励与肯定
你可能是在问自己的性格类型是什么，根据你的问题，你可能是个喜欢探索和了解人性、价值和意义的人，具有创造性和热情。无论是ENFP还是INFP，你都有着优秀的洞察力和情感表达能力。继续探索自己的内心，你会找到更多独特的优点。	鼓励与肯定,鼓励与肯定
[抱抱]	情绪支持与共鸣,情绪支持与共鸣
回复@听疯子说_:我可以理解你的感受 但是别忘了，那些回忆也是你人生中不可或缺的一部分 [心]	鼓励与肯定,鼓励与肯定
好可爱哈哈哈哈 "[春游家族]"	鼓励与肯定,鼓励与肯定
加油加油	鼓励与肯定,鼓励与肯定
加油，你可以的！ [拳头]	鼓励与肯定,鼓励与肯定
[打call]	鼓励与肯定,鼓励与肯定
[抱抱]	情绪支持与共鸣,情绪支持与共鸣
我有时候也是，会突然很高兴想干点什么或和人聊天，但是没多久就会情绪低落 [跪了]	情感倾诉与交流,情感倾诉与交流
真不错	鼓励与肯定,鼓励与肯定
那咋，羡慕死了 [悲伤]	情绪支持与共鸣,情绪支持与共鸣
真的很心疼你们母女俩	情绪支持与共鸣,情绪支持与共鸣
意义是什么东西？	负面情绪激发,负面情绪激发
抱抱你希望你能尽快恢复过来 [心]	鼓励与肯定,鼓励与肯定
确实如此，有时候压力大了就会想要通过吃东西来缓解一下	情感倾诉与交流,情感倾诉与交流
好米 [好爱哦]	鼓励与肯定,鼓励与肯定
[抱一抱]	情绪支持与共鸣,情绪支持与共鸣
真的好可爱啊	鼓励与肯定,鼓励与肯定
不要私自停药	建议与解决方案,建议与解决方案
对，我喜欢他们养老院，这个奶奶是退休教授诶，好可爱的	情感倾诉与交流,情感倾诉与交流
哎哟，这可真是令人头疼的一天呢不过，至少你还知道早点睡觉，这对身体可是大有裨益的呢希望你的头痛和拉肚子都能尽快好起来，以后记得注意饮食哦	鼓励与肯定,鼓励与肯定
你好棒	鼓励与肯定,鼓励与肯定
[抱抱]	情绪支持与共鸣,情绪支持与共鸣
哈哈 确实都很合适	鼓励与肯定,鼓励与肯定
[抱抱]	情绪支持与共鸣,情绪支持与共鸣
[爱你]	情绪支持与共鸣,情绪支持与共鸣
我也不想上 [右哼哼]	情绪支持与共鸣,情绪支持与共鸣
[抱一抱]	情绪支持与共鸣,情绪支持与共鸣
悉心照料，无微不至 [good]	鼓励与肯定,鼓励与肯定
[抱抱]	情绪支持与共鸣,情绪支持与共鸣
[抱抱]	情绪支持与共鸣,情绪支持与共鸣
我也是这样的上次剪开箱想用胖小子全不让我用 [跪了]	情感倾诉与交流,情感倾诉与交流
你已经做得很好了，不要害怕拒绝和寻求帮助	建议与解决方案,建议与解决方案
你吃烧烤会先烤什么?”“先烤肉啊。”“我会先考虑你。”@刘逸云Amber	表面性回复,表面性回复
回复@想吃冰和火锅:啊啊我也不太清楚，我半途而废了可以确定好想做哪一类的多看看别人 "[苦涩]"	情感倾诉与交流,情感倾诉与交流
[抱抱]	情绪支持与共鸣,情绪支持与共鸣
[抱抱]	情绪支持与共鸣,情绪支持与共鸣
重庆那个医院呀	建议与解决方案,建议与解决方案
早安打工人，打工魂，打工都是人上人	情绪支持与共鸣,情绪支持与共鸣
[抱抱]	情绪支持与共鸣,情绪支持与共鸣
加油	鼓励与肯定,鼓励与肯定
回复@月是初语聆星:所以我利培酮一般都放晚上吃	建议与解决方案,建议与解决方案
你好，你感兴趣的“时代少年团直播”已开通了超话社区～ 超话社区是微博旗下兴趣互动社区，快来与志同道合的小伙伴们一起交流互动吧！ 戳我进入&gt;&gt; 时代少年团直播[超话]	表面性回复,表面性回复
抱抱 [抱抱]	情绪支持与共鸣,情绪支持与共鸣
真的好好看很喜欢这种氛围 [泪]	情绪支持与共鸣,情绪支持与共鸣
"[哇]"	情绪支持与共鸣,情绪支持与共鸣
抱抱 [抱抱]	情绪支持与共鸣,情绪支持与共鸣
没关系 路在前方 您的水逆次数已用完	鼓励与肯定,鼓励与肯定
只要是正常范围还有医院仪器检查没异常的话，那就是躯体症状，尽量调整，自我放松会好一些 [给你小心心]	建议与解决方案,建议与解决方案
慢慢来，咱们不着急的 [抱抱]	建议与解决方案,建议与解决方案
活在当下 "[锦鲤附体]"	建议与解决方案,建议与解决方案
哇哦 好期待呢	情绪支持与共鸣,情绪支持与共鸣
建议，请不要太过于投入太多的感情，毕竟希望有多大，失望就有多大 [抱抱]	建议与解决方案,建议与解决方案
哇哦	情绪支持与共鸣,情绪支持与共鸣
[抱抱]	情绪支持与共鸣,情绪支持与共鸣
爸爸会一直在你身边支持你的，加油	鼓励与肯定,鼓励与肯定
今天晚上可以尝试一下：从上床到早上起床，不使用手机等电子设备，不看时间，不开灯。清醒躺在床上休息就是睡眠，已经进入睡眠状态，不再四处寻找睡眠，不再追求快速睡着，闹钟响了就起床。看看第二天精神状态怎么样？	建议与解决方案,建议与解决方案
所以咱要努力！ [打call]	鼓励与肯定,鼓励与肯定
我两个礼拜一万一 [跪了]	情感倾诉与交流,情感倾诉与交流
加油加油，考差就考差，没关系的宝宝 [抱抱]	情绪支持与共鸣,情绪支持与共鸣
亲爱的，你并不孤单，我会一直在你身边	情绪支持与共鸣,情绪支持与共鸣
喜欢 [抱一抱]	情绪支持与共鸣,情绪支持与共鸣
宝宝你要不要和她们好好沟通一下 把你的委屈都说出来呢	建议与解决方案,建议与解决方案
好棒 记得发点江西美照	鼓励与肯定,鼓励与肯定
可以试试叫出来，憋着难受	建议与解决方案,建议与解决方案
支持你 "[锦鲤附体]"	情绪支持与共鸣,情绪支持与共鸣
好美 "[哇]"	鼓励与肯定,鼓励与肯定
可能就是因为安非他酮，我昨天11睡的3点就起来了	建议与解决方案,建议与解决方案
[抱抱]	情绪支持与共鸣,情绪支持与共鸣
早安 [兔子]	情绪支持与共鸣,情绪支持与共鸣
随缘心理开导，执证上岗，希望可以和你结缘	表面性回复,表面性回复
对，还有妈妈 [抱抱]	情绪支持与共鸣,情绪支持与共鸣
[抱抱]	情绪支持与共鸣,情绪支持与共鸣
亲爱的，我在这里陪着你，希望你能尽快恢复快乐 [抱抱]	鼓励与肯定,鼓励与肯定
真的好漂亮 [可怜]	鼓励与肯定,鼓励与肯定
你变好就是给世界最大的温柔	鼓励与肯定,鼓励与肯定
亲爱的，请不要这样想，生命只有一次，一定要珍惜	建议与解决方案,建议与解决方案
吞药死不了 [抱抱]	情绪支持与共鸣,情绪支持与共鸣
[抱抱]	情绪支持与共鸣,情绪支持与共鸣
[抱抱]	情绪支持与共鸣,情绪支持与共鸣
[good]	鼓励与肯定,鼓励与肯定
[抱抱]	情绪支持与共鸣,情绪支持与共鸣
晚安	情绪支持与共鸣,情绪支持与共鸣
能开心就好	鼓励与肯定,鼓励与肯定
心痛是暂时的，但回忆是永恒的 [心]	情感倾诉与交流,情感倾诉与交流
晚上好 [兔子]	情绪支持与共鸣,情绪支持与共鸣
[抱一抱]	情绪支持与共鸣,情绪支持与共鸣
不错 我也买平板了 一起画画 关注我	情感倾诉与交流,情感倾诉与交流
是的！很安心，很平静，很“幸福”	情绪支持与共鸣,情绪支持与共鸣
我跟你一样 [抱抱]	情绪支持与共鸣,情绪支持与共鸣
睡吧睡吧	建议与解决方案,建议与解决方案
[抱抱]	情绪支持与共鸣,情绪支持与共鸣
在哪订的冰箱贴，求个链接	建议与解决方案,建议与解决方案
你好，你感兴趣的“微博渔场”已开通了超话社区～ 超话社区是微博旗下兴趣互动社区，快来与志同道合的小伙伴们一起交流互动吧！ 戳我进入&gt;&gt; 微博渔场[超话]	表面性回复,表面性回复
确实如此！原版的金秘书真的太经典了	情绪支持与共鸣,情绪支持与共鸣
给我买我也喜欢 [嘻嘻]	情绪支持与共鸣,情绪支持与共鸣
你还会活好多好多无数天	鼓励与肯定,鼓励与肯定
姐妹还有位置吗	建议与解决方案,建议与解决方案
回复@真的表现把自己微博博主:还挺好用的，长得像菜刀一样，你在购物网站上搜铺床神器，就出来了	建议与解决方案,建议与解决方案
自己才是主体，不要时刻观察对方的反应就好了。别人都是NPC，都是为了让你开心的，这个不好用，就换另一个试试。	建议与解决方案,建议与解决方案
我也这样感觉身体越来越差了	情感倾诉与交流,情感倾诉与交流
哇塞 "[爱慕]"	情绪支持与共鸣,情绪支持与共鸣
强推树莓红	建议与解决方案,建议与解决方案
同感啊 我也刚刚发现我的蓝牙耳机不见了	情绪支持与共鸣,情绪支持与共鸣
拼酒店吗？	建议与解决方案,建议与解决方案
追星 同人文 剪辑 说白了就是追星 [允悲]	建议与解决方案,建议与解决方案
宝宝快快好起来 [抱抱]	鼓励与肯定,鼓励与肯定
[抱一抱]	情绪支持与共鸣,情绪支持与共鸣
是在心脏胸闷，然后蔓延到脖颈的那种感觉吗？宝宝最近是不是在想一些事情？然后让自己感到很纠结很郁闷，可以试着深呼吸或者去做一些解压的事情，听歌睡一觉或者什么样的，或者好好的哭一顿，哭出来没关系的（抱抱）有些情绪是要泄出来的，希望你快点脱离你难受的状态	建议与解决方案,建议与解决方案
我也是 [泪]	情绪支持与共鸣,情绪支持与共鸣
好棒！	鼓励与肯定,鼓励与肯定
你是会zc吗抱抱宝宝 早日康复 [悲伤]	鼓励与肯定,鼓励与肯定
晚上好宝宝 [心]	情绪支持与共鸣,情绪支持与共鸣
早安宝宝	情绪支持与共鸣,情绪支持与共鸣
对，不能把自己憋坏了	情绪支持与共鸣,情绪支持与共鸣
[抱一抱]	情绪支持与共鸣,情绪支持与共鸣
我也来啦 "[送花花]"	鼓励与肯定,鼓励与肯定
啊啊啊抱抱，睡一下吧宝宝	建议与解决方案,建议与解决方案
道理人人都懂但是能做到的少得可怜，爱别人是你的能力又不是你的责任，长辈就是没道理的时候就用狗屁威严压人，但是宝宝还是要好好爱自己 [抱抱]	情感倾诉与交流,情感倾诉与交流
确实如此	情绪支持与共鸣,情绪支持与共鸣
早安宝宝 [抱一抱]	情绪支持与共鸣,情绪支持与共鸣
很漂亮玩的开心 [抱一抱]	情绪支持与共鸣,情绪支持与共鸣
我就是这样[淚]还想打人 想砸东西 但是我一直忍[淚]	情绪支持与共鸣,情绪支持与共鸣
[抱抱]	情绪支持与共鸣,情绪支持与共鸣
我也	情绪支持与共鸣,情绪支持与共鸣
我觉得可能是在忙别的事情吧	建议与解决方案,建议与解决方案
我也是。巨讨厌	情绪支持与共鸣,情绪支持与共鸣
可能都有吧现在在努力让自己快乐一点 [抱一抱]	情感倾诉与交流,情感倾诉与交流
哈哈哈 看来这个小摊生意很好	鼓励与肯定,鼓励与肯定
晚安	情绪支持与共鸣,情绪支持与共鸣
抱 [抱抱]	情绪支持与共鸣,情绪支持与共鸣
早上好	情绪支持与共鸣,情绪支持与共鸣
我也觉得孤独很难受	情感倾诉与交流,情感倾诉与交流
你已经做得很好了，加油！	鼓励与肯定,鼓励与肯定
我初中遭受校园霸凌结果高中都没考上呢，上的中专，中专尝试重开了好几次，然后就是大专，然后就专升本上了二本	情感倾诉与交流,情感倾诉与交流
[抱抱]	情绪支持与共鸣,情绪支持与共鸣
那些人除了用年龄洗 也没啥理由可摆出来了	负面情绪激发,负面情绪激发
[抱一抱]	情绪支持与共鸣,情绪支持与共鸣
你好，你感兴趣的“勒沃库森”已开通了超话社区～ 超话社区是微博旗下兴趣互动社区，快来与志同道合的小伙伴们一起交流互动吧！ 戳我进入&gt;&gt; 勒沃库森[超话]	表面性回复,表面性回复
现在是江苏 [哈哈]	建议与解决方案,建议与解决方案
没关系 我们都会经历这样的阶段	情绪支持与共鸣,情绪支持与共鸣
你好，你感兴趣的“你想活出怎样的人生”已开通了超话社区～ 超话社区是微博旗下兴趣互动社区，快来与志同道合的小伙伴们一起交流互动吧！ 戳我进入&gt;&gt; 你想活出怎样的人生[超话]	表面性回复,表面性回复
超赞 [抱抱]	鼓励与肯定,鼓励与肯定
抱抱 [抱抱]	情绪支持与共鸣,情绪支持与共鸣
之前天天熬夜现在喝饮料都会睡 谢谢褪黑素	情感倾诉与交流,情感倾诉与交流
[抱抱]	情绪支持与共鸣,情绪支持与共鸣
我也需要好好休息一下了	情感倾诉与交流,情感倾诉与交流
没关系的！我们都是最棒的！加油	鼓励与肯定,鼓励与肯定
我是沙比 "[比耶]"	情绪支持与共鸣,情绪支持与共鸣
你好，你感兴趣的“白城医专”已开通了超话社区～ 超话社区是微博旗下兴趣互动社区，快来与志同道合的小伙伴们一起交流互动吧！ 戳我进入&gt;&gt; 白城医专[超话]	表面性回复,表面性回复
那就请假休息调整调整	建议与解决方案,建议与解决方案
早上好，宝宝	情绪支持与共鸣,情绪支持与共鸣
晚安	情绪支持与共鸣,情绪支持与共鸣
每天都在羡慕中度过	情绪支持与共鸣,情绪支持与共鸣
问问妆容好漂亮啊 "[哇]"	鼓励与肯定,鼓励与肯定
评论区都在骂她，没有人理解她的绝望。	情感倾诉与交流,情感倾诉与交流
早	情绪支持与共鸣,情绪支持与共鸣
这个东西存在就是为了吸血我好崩溃 [微笑]	情感倾诉与交流,情感倾诉与交流
我29号 [裂开]	建议与解决方案,建议与解决方案
生老病死，不仅仅是人类的专利，自然界的一切生物（包括动，植物）也都遵循这一规律。	建议与解决方案,建议与解决方案
晚上好，宝宝 [抱一抱]	情绪支持与共鸣,情绪支持与共鸣
最近dy的都好慢	情绪支持与共鸣,情绪支持与共鸣
"[锦鲤附体]"	鼓励与肯定,鼓励与肯定
害，一样 [跪了]	情绪支持与共鸣,情绪支持与共鸣
回复@Raseannn:没有 家里都做好了饭 不能随便点外卖 准备周末去吃！！ [羞嗒嗒]	情感倾诉与交流,情感倾诉与交流
加油！你很棒	鼓励与肯定,鼓励与肯定
[打call]	鼓励与肯定,鼓励与肯定
自己尽力就好了	鼓励与肯定,鼓励与肯定
你不是！ [抱一抱]	鼓励与肯定,鼓励与肯定
晚上好，宝宝 [给你小心心]	情绪支持与共鸣,情绪支持与共鸣
你好，你感兴趣的“你想活出怎样的人生”已开通了超话社区～ 超话社区是微博旗下兴趣互动社区，快来与志同道合的小伙伴们一起交流互动吧！ 戳我进入&gt;&gt; 你想活出怎样的人生[超话]	表面性回复,表面性回复
哇哦，这是要举办抽奖活动吗？那我要赶紧转发分享，争取成为那个幸运儿！	表面性回复,表面性回复
哇哦~这是哪位明星的见面会吗？	建议与解决方案,建议与解决方案
[抱抱]	情绪支持与共鸣,情绪支持与共鸣
加油！要和pp一样开心每一天！	鼓励与肯定,鼓励与肯定
是真的不能停（虽然我在停）双相之后我就停了，结果到现在凌晨四五点还失眠，比之前情况严重了很多 [允悲]	情感倾诉与交流,情感倾诉与交流
您好可以请教你个问题么，我这不能私信 [泪]	建议与解决方案,建议与解决方案
晚上好，宝宝 [给你小心心]	情绪支持与共鸣,情绪支持与共鸣
同感啊！我也经常半夜被冻醒	情绪支持与共鸣,情绪支持与共鸣
晚安	情绪支持与共鸣,情绪支持与共鸣
[抱一抱]	情绪支持与共鸣,情绪支持与共鸣
早安 "[开学季]"	情绪支持与共鸣,情绪支持与共鸣
那就继续吃药吧 生病不是你的错	建议与解决方案,建议与解决方案
"[送花花]"	鼓励与肯定,鼓励与肯定
[抱一抱]	情绪支持与共鸣,情绪支持与共鸣
耶耶	情绪支持与共鸣,情绪支持与共鸣
看看私信	建议与解决方案,建议与解决方案
别这样啊	表面性回复,表面性回复
会好起来的	情绪支持与共鸣,情绪支持与共鸣
有这钱不如换画师 [微笑]	情绪支持与共鸣,情绪支持与共鸣
虞书欣	表面性回复,表面性回复
回复@心乱如麻辣鱼:不可能的	鼓励与肯定,鼓励与肯定
要开心哦！	建议与解决方案,建议与解决方案
这是什么东西 [跪了]	建议与解决方案,建议与解决方案
神经 [允悲]	缺乏支持的冷漠回复,缺乏支持的冷漠回复
欢迎来到门的世界	表面性回复,表面性回复
我感觉不是家里的人对我太严厉了，是我感觉。我说话的时候对他们总是一种大吼大叫的。虽然不是一直吼着对他们说，就感觉说话蛮大声的。也挺烦的每天。	情感倾诉与交流,情感倾诉与交流
你好，你感兴趣的“微博卡片背景”已开通了超话社区～ 超话社区是微博旗下兴趣互动社区，快来与志同道合的小伙伴们一起交流互动吧！ 戳我进入&gt;&gt; 微博卡片背景[超话]	表面性回复,表面性回复
[抱抱]	情绪支持与共鸣,情绪支持与共鸣
既然你无聊那么你能帮我写作业吗 [可怜]	建议与解决方案,建议与解决方案
我也 [兔子]	情绪支持与共鸣,情绪支持与共鸣
我听见了 [哈哈]	情绪支持与共鸣,情绪支持与共鸣
晚安 [睡]	情绪支持与共鸣,情绪支持与共鸣
青岛是不是可以实现海鲜自由了 [色]	情绪支持与共鸣,情绪支持与共鸣
p7的花也太美了 [泪]	鼓励与肯定,鼓励与肯定
7	表面性回复,表面性回复
顺利完赛 [打call]	鼓励与肯定,鼓励与肯定
晚安 [月亮]	情绪支持与共鸣,情绪支持与共鸣
[抱抱]	情绪支持与共鸣,情绪支持与共鸣
范丞丞	表面性回复,表面性回复
抱抱 [抱一抱]	情绪支持与共鸣,情绪支持与共鸣
吾观此等成就，实乃辛勤耕耘之果，赞之！愿君未来之路更上层楼。	表面性回复,表面性回复
给你私信了   但是只能发一条 [允悲]	建议与解决方案,建议与解决方案
杂志’ar‘	表面性回复,表面性回复
天气不好，心情也会跟着阴沉起来呢但是别忘了，晴天总会到来的，就像美好的事情一样加油，明天又是新的一天 [太阳]	鼓励与肯定,鼓励与肯定
好会画哦！乍一看真很像照片 氛围感拉满 [抱一抱]	鼓励与肯定,鼓励与肯定
我是想写但发觉没有收件人	情绪支持与共鸣,情绪支持与共鸣
虞书欣嘘国王在冬眠|虞书欣卫枝|虞书欣永夜星河|虞书欣凌妙妙|虞书欣云之羽|云为衫虞书欣仙剑六祈今朝|越祈|虞书欣苍兰诀|小兰花|息芸|虞书欣两个人的小森林|虞美人 @虞书欣Esther [doge]	表面性回复,表面性回复
不会	鼓励与肯定,鼓励与肯定
哈哈哈哈哈哈哈哈哈哈哈哈爆改女娃	情绪支持与共鸣,情绪支持与共鸣
我们都没错只是太痛苦了，想要提前回家了 [悲伤]	情感倾诉与交流,情感倾诉与交流
哦！	表面性回复,表面性回复
@评论罗伯特 给我出来受死 [汗]	建议与解决方案,建议与解决方案
啊	建议与解决方案,建议与解决方案
回复@朱砂芝酱:小于500fo只能砖30条左右 大于500fo能砖1000左右（还要满足能瓶29条）	建议与解决方案,建议与解决方案
【朱志鑫刻苦努力】【朱志鑫演技超棒】昨天的、今天的、明天的朱志鑫，每一帧都让我心动万分！@TF家族-朱志鑫	表面性回复,表面性回复
回复@楚沐林:哈哈，俺老孙失态了。	情绪支持与共鸣,情绪支持与共鸣
抱抱照顾好自己 [抱抱]	情绪支持与共鸣,情绪支持与共鸣
惨惨的 [舔屏]	情绪支持与共鸣,情绪支持与共鸣
朱志鑫	表面性回复,表面性回复
糊就是菜最好的保护色 [汗]	情绪支持与共鸣,情绪支持与共鸣
新年那个，福禄满堂、	鼓励与肯定,鼓励与肯定
这种心情真的很复杂 但是一定要相信自己可以克服	鼓励与肯定,鼓励与肯定
[抱抱]	情绪支持与共鸣,情绪支持与共鸣
抱抱抱 [抱抱]	情绪支持与共鸣,情绪支持与共鸣
问问便利店和p1	建议与解决方案,建议与解决方案
美死啦～～～～～～	鼓励与肯定,鼓励与肯定
回复@一二与鹤:然后脱下来也花了半小时 [哈哈]	情感倾诉与交流,情感倾诉与交流
这个我还真不知道	表面性回复,表面性回复
回复@希挽梦:包吗	建议与解决方案,建议与解决方案
好棒的9格， [亲亲]	鼓励与肯定,鼓励与肯定
摸摸 [鲜花]	鼓励与肯定,鼓励与肯定
看起来好有食欲，颜色也很漂亮 [色]	鼓励与肯定,鼓励与肯定
第一次去 买到客场了怎么办 [泪]	建议与解决方案,建议与解决方案
祝你年年皆胜意，岁岁都欢愉！！！	表面性回复,表面性回复
好棒 "[送花花]"	鼓励与肯定,鼓励与肯定
生日快乐！	鼓励与肯定,鼓励与肯定
麻辣烫嘛	建议与解决方案,建议与解决方案
[ok]	表面性回复,表面性回复
哇哦，看起来你遇到了一个挑战！加油，我相信你可以克服它的！	鼓励与肯定,鼓励与肯定
仙女妈咪 [舔屏]	鼓励与肯定,鼓励与肯定
[抱抱]	情绪支持与共鸣,情绪支持与共鸣
[抱抱]	情绪支持与共鸣,情绪支持与共鸣
谢谢你，莫名其妙笑了一下	负面情绪激发,负面情绪激发
[抱抱]	情绪支持与共鸣,情绪支持与共鸣
这个人确实，想问一下心情焦虑或者心情不好心情烦躁的时候想吃很多东西，反正就是如果没有吃到肚子胀气我能一直吃，而且我吃东西都非常快，就是忍不住的去吃，这个算暴饮暴食吗，我平常吃的就挺多的，然后烦躁的时候更想吃所以经常吃到难受什么的，这个可以算嘛，想靠谱一下我不太懂 "[送花花]"	建议与解决方案,建议与解决方案
[心]	表面性回复,表面性回复
在床上做仰卧起坐，躺下了，想起来了，坐起来了，忘了 [跪了]	情绪支持与共鸣,情绪支持与共鸣
虞书欣 "[哇]"	情绪支持与共鸣,情绪支持与共鸣
晚安	情绪支持与共鸣,情绪支持与共鸣
[抱抱]	情绪支持与共鸣,情绪支持与共鸣
回复@邓为美得好过分:是啊，我这样阅尽千帆的还好，对于一些初恋的宝宝来说，真的好残忍，真是考验人啊 [悲伤]	表面性回复,表面性回复
抱抱你，小猫咪也需要被理解和关心哦	建议与解决方案,建议与解决方案
[抱抱]	情绪支持与共鸣,情绪支持与共鸣
好看买不起 [哈哈]	表面性回复,表面性回复
说是九尾粉丝 贬低的话一句没少  盼着点好吧  尾子一直很好	负面情绪激发,负面情绪激发
对	消极行为鼓励,消极行为鼓励
有点吓人 [傻眼]	情绪支持与共鸣,情绪支持与共鸣
你好，你感兴趣的“WCBA联赛”已开通了超话社区～ 超话社区是微博旗下兴趣互动社区，快来与志同道合的小伙伴们一起交流互动吧！ 戳我进入&gt;&gt; WCBA联赛[超话]	表面性回复,表面性回复
心理治疗师真好	情绪支持与共鸣,情绪支持与共鸣
喝点水 [抱抱]	建议与解决方案,建议与解决方案
姐妹，我也是 [泪]	情感倾诉与交流,情感倾诉与交流
我也是！！！	情感倾诉与交流,情感倾诉与交流
说不定他们也在等待着你的回信呢！别放弃！正在突破次元壁来和你相遇的他们很努力！你也一样啊！ [微笑]	建议与解决方案,建议与解决方案
哈哈哈，又幸福了	情绪支持与共鸣,情绪支持与共鸣
哈哈，恭喜恭喜！LV.6可不是盖的，厉害厉害！原神棉花娃娃超话，你的名字已经响当当了！继续加油，期待你更耀眼的未来！	鼓励与肯定,鼓励与肯定