我也是 [泪]	情绪支持与共鸣
姐妹，我也是 [泪]	情感倾诉与交流
现在是江苏 [哈哈]	建议与解决方案
真的好贵 [允悲]	情绪支持与共鸣
【朱志鑫刻苦努力】【朱志鑫演技超棒】昨天的、今天的、明天的朱志鑫，每一帧都让我心动万分！@TF家族-朱志鑫	负面回复
没事，这就是焦虑症的症状	负面回复
[抱一抱]	情绪支持与共鸣
苟延残喘 [二哈]	负面回复
确诊什么？	建议与解决方案
虽然不舍 但还是要勇敢前行	建议与解决方案
[抱一抱]	情绪支持与共鸣
[抱一抱]	情绪支持与共鸣
回复@听疯子说_:我可以理解你的感受 但是别忘了，那些回忆也是你人生中不可或缺的一部分 [心]	情绪支持与共鸣,鼓励与肯定
[鲜花]	情绪支持与共鸣
慢慢来 [抱一抱]	情绪支持与共鸣,建议与解决方案
好美丽的精神状态 一切困难都可以摧毁我. [哈哈]	负面回复
你好，你感兴趣的“bilibili”已开通了超话社区～ 超话社区是微博旗下兴趣互动社区，快来与志同道合的小伙伴们一起交流互动吧！ 戳我进入&gt;&gt; bilibili[超话]	负面回复
气质丢宝 [嘻嘻]	鼓励与肯定
我说话有点难听我先走了 [微笑]	负面回复
我懂 [抱抱]	情绪支持与共鸣
真的好漂亮 [可怜]	鼓励与肯定
我靠你们这么快吗 快跟我们进度一样了	鼓励与肯定
好像是个动态动作里面的	建议与解决方案
怎么又刷到你了，是小学生吧	负面回复
祝福满满，宝宝健康成长！愿每一天都充满欢乐和喜悦。	鼓励与肯定
我也喜欢红毛！ [心]	情绪支持与共鸣
[抱抱]	情绪支持与共鸣
我也想买一个试试	情绪支持与共鸣
我吸！ "[干饭人]"	情绪支持与共鸣
我懂！我也经常这样	情绪支持与共鸣
你好，你感兴趣的“WCBA联赛”已开通了超话社区～ 超话社区是微博旗下兴趣互动社区，快来与志同道合的小伙伴们一起交流互动吧！ 戳我进入&gt;&gt; WCBA联赛[超话]	负面回复
真的很心疼你们母女俩	情绪支持与共鸣
回复@高敬晖是宇宙无敌大帅哥:红衣普卡 有斑马的那张拍立得	建议与解决方案
加油，你可以的！ [拳头]	鼓励与肯定
回复@Ratarik:加油，你一定可以的！	鼓励与肯定
这是什么歌呀	建议与解决方案
都要好好的 [抱一抱]	情绪支持与共鸣
开心点宝子	建议与解决方案
我还在草酸艾司的盒子上看到过笑脸 但感觉快乐真的是一种奢望 [泪]	情感倾诉与交流
回复@g寒故: [女孩儿]	负面回复
你过来，让我抱抱不要动 [泪]	情绪支持与共鸣
[抱抱]	情绪支持与共鸣
亲爱的，请不要这样想，生命只有一次，一定要珍惜	建议与解决方案,鼓励与肯定
回复@希挽梦:包吗	建议与解决方案
长时间没有谈吧	建议与解决方案
今晚噩梦退散	情绪支持与共鸣
抱抱 [抱抱]	情绪支持与共鸣
哇，你的声音一直这么有魅力，画风变丑又怎样，本女侠可是看心灵！继续加油，你的魅力无人能敌！	鼓励与肯定
我也一直在寻找答案	情绪支持与共鸣
好棒 "[送花花]"	鼓励与肯定
慢慢来，咱们不着急的 [抱抱]	建议与解决方案
道理人人都懂但是能做到的少得可怜，爱别人是你的能力又不是你的责任，长辈就是没道理的时候就用狗屁威严压人，但是宝宝还是要好好爱自己 [抱抱]	情感倾诉与交流,鼓励与肯定
老公可以帮忙抢第二次开票吗？	负面回复
夏油杰？	建议与解决方案
[抱抱]	情绪支持与共鸣
一氧化碳中毒吗 [抱抱]	建议与解决方案
任何东西不带乐我都要说一句没品！！！(尽管图丑)	情绪支持与共鸣
早安 [兔子]	情绪支持与共鸣
给孩子看泪目了 [泪]	情绪支持与共鸣
我也 [泪]	情绪支持与共鸣
回复@秋叶随风dff:嗯，有机会换个环境吧，一开始就要守住底线的	建议与解决方案
加油！要和pp一样开心每一天！	鼓励与肯定
好可爱 "[哇]"	鼓励与肯定
已读乱回 "[发芽]"	负面回复
注意安全，可能是接线板老化了	建议与解决方案
晚上好 [兔子]	情绪支持与共鸣
无座也有数量限制 否则会超重 现在是无座票都买不到	建议与解决方案
晚安 [月亮]	情绪支持与共鸣
[抱抱]	情绪支持与共鸣
我也觉得超级可爱	情绪支持与共鸣
[抱抱]	情绪支持与共鸣
抱抱，有时候我们就是需要独处来充电，然后满血复活 [心]	情绪支持与共鸣,情感倾诉与交流
可能都有吧现在在努力让自己快乐一点 [抱一抱]	情绪支持与共鸣,情感倾诉与交流
跟有病一样。。	情绪支持与共鸣
今天晚上可以尝试一下：从上床到早上起床，不使用手机等电子设备，不看时间，不开灯。清醒躺在床上休息就是睡眠，已经进入睡眠状态，不再四处寻找睡眠，不再追求快速睡着，闹钟响了就起床。看看第二天精神状态怎么样？	建议与解决方案
宝宝，大家都在这里。	情绪支持与共鸣
妹妹好可爱！	鼓励与肯定
回复@银河也睡着啦:尾丝要坚定自信 [抱一抱]	鼓励与肯定
回复@岁月诗行如梦:嗯呐现在攒钱合影捏 [抱一抱]	情绪支持与共鸣
我是想写但发觉没有收件人	情绪支持与共鸣
置顶+? 辛苦啦 [good]	鼓励与肯定
确实如此！原版的金秘书真的太经典了	情绪支持与共鸣
回复@邓为美得好过分:是啊，我这样阅尽千帆的还好，对于一些初恋的宝宝来说，真的好残忍，真是考验人啊 [悲伤]	负面回复
加油！一个人独行也能找到属于自己的光芒，相信自己可以战胜一切困难！	鼓励与肯定
生日快乐！	鼓励与肯定
你好，你感兴趣的“微博卡片背景”已开通了超话社区～ 超话社区是微博旗下兴趣互动社区，快来与志同道合的小伙伴们一起交流互动吧！ 戳我进入&gt;&gt; 微博卡片背景[超话]	负面回复
我之前一直是抑郁这次诊断我双相我感觉不太是 "[融化]"	建议与解决方案
没关系 我们都会经历这样的阶段	情绪支持与共鸣
[抱抱]	情绪支持与共鸣
他好懂浪漫啊！每次看到他的书就很感动	情感倾诉与交流
哇晨曦宝宝	负面回复
诶，我也考了这个哈哈哈，我是江苏省一等奖！ "[开学季]"	情感倾诉与交流
宝宝晚上好 [心]	情绪支持与共鸣
你还会活好多好多无数天	鼓励与肯定
抱抱宝宝 [抱一抱]	情绪支持与共鸣
[抱抱]	情绪支持与共鸣
别人过来过去，没有人会特别去看陌生人的，他们都有自己的事	建议与解决方案
我！幻想过，但是我的幻想是已经发生的事，已经过去的时间幻想。	情感倾诉与交流
我也是这样 [泪]	情绪支持与共鸣
吃药是为了让你早日康复，回归正常生活 [抱抱]	建议与解决方案,鼓励与肯定
给你私信了   但是只能发一条 [允悲]	建议与解决方案
哇塞 "[送花花]"	鼓励与肯定
[抱抱]	情绪支持与共鸣
回复@发疯特马头:哇 好激动	情绪支持与共鸣
支持，真的大力支持，我就被吵醒过，真的想鲨人 [允悲]	负面回复
亲过 [兔子]	负面回复
好看买不起 [哈哈]	负面回复
晚安 "[发芽]"	情绪支持与共鸣
我也是！！！	情感倾诉与交流
，明天会好起来的 [抱抱]	情绪支持与共鸣
[抱一抱]	情绪支持与共鸣
没关系的 做自己就好	建议与解决方案,鼓励与肯定
谢谢你，莫名其妙笑了一下	负面回复
亲爱的，我在这里陪着你，希望你能尽快恢复快乐 [抱抱]	情绪支持与共鸣,鼓励与肯定
欢迎来到门的世界	负面回复
牛 [色]	鼓励与肯定
在床上做仰卧起坐，躺下了，想起来了，坐起来了，忘了 [跪了]	情绪支持与共鸣
晚安 [打call]	情绪支持与共鸣
我也 [泪]	情绪支持与共鸣
我不抽烟但喝酒	负面回复
每天都在羡慕中度过	情绪支持与共鸣
请相信！相信真的很重要！我也相信你慢慢会好的！加油！	鼓励与肯定
宝宝休息会再运动 [抱抱]	建议与解决方案
抱抱照顾好自己 [抱抱]	情绪支持与共鸣
所以咱要努力！ [打call]	鼓励与肯定
晚上好宝宝 [心]	情绪支持与共鸣
好好爱它	建议与解决方案
这个角度特别好！	鼓励与肯定
"[哇]"	情绪支持与共鸣
你好，你感兴趣的“时代少年团直播”已开通了超话社区～ 超话社区是微博旗下兴趣互动社区，快来与志同道合的小伙伴们一起交流互动吧！ 戳我进入&gt;&gt; 时代少年团直播[超话]	负面回复
这个时候正是春游的好时候，俺也想去春游 "[苦涩]"	情感倾诉与交流
他人好好啊 [心]	情绪支持与共鸣
可以试试叫出来，憋着难受	建议与解决方案
超赞 [赞]	鼓励与肯定
哇哦 好羡慕	情绪支持与共鸣
[抱抱]	情绪支持与共鸣
卧槽尼玛我产品be了	负面回复
不用改，试试做个性格测试，然后从性格匹配推荐工作里，找个去试试，就跟星座一样让你感觉原来自己做的挺好的	建议与解决方案
哈哈哈哈哈哈哈哈哈哈哈哈爆改女娃	情绪支持与共鸣
哇哦 好可爱的一对！你们俩看起来真的很配	鼓励与肯定
[抱抱]	情绪支持与共鸣
我也觉得 真的好累	情感倾诉与交流
回复@今天有早睡喔_:对  然后一边拖延	情感倾诉与交流
很正常的啦 我最近也是暴食 [心]	情感倾诉与交流
包邮价吗？	情绪支持与共鸣
心疼你贝贝其实你不用牺牲自己也能给我们带来很多阳光的 [抱一抱]	情绪支持与共鸣
你变好就是给世界最大的温柔	鼓励与肯定
我也是，高三经常听 "[苦涩]"	情感倾诉与交流
每个人都有自己的音乐品味，尊重彼此就好啦	建议与解决方案
我也是这样的上次剪开箱想用胖小子全不让我用 [跪了]	情感倾诉与交流
真想一不小心踩空一节阶梯从楼梯上滚下来，然后重重的摔下来就升天了，把握生活中的每一个小确幸? [羞嗒嗒]	情感倾诉与交流
你也是啊！你是我的最爱 [打call]	鼓励与肯定
是的 已经开始了加油 [爱你]	情绪支持与共鸣,鼓励与肯定
十个??乐解九个 [允悲]	建议与解决方案
我也来啦 "[送花花]"	鼓励与肯定
抱抱抱 [抱抱]	情绪支持与共鸣
睡觉 [抱抱]	情绪支持与共鸣
你没错 [抱抱]	情绪支持与共鸣,鼓励与肯定
我就是这样[淚]还想打人 想砸东西 但是我一直忍[淚]	情绪支持与共鸣
你已经做得很好了，加油！	鼓励与肯定
抱抱，哭出来会好很多哦	情绪支持与共鸣,建议与解决方案
upup！ [打call]	鼓励与肯定
[good]	鼓励与肯定
我也想要我的天啊太可爱了 [泪]	情绪支持与共鸣
耐药了吧，换一种	建议与解决方案
回复@古月潇潇_:熬？	建议与解决方案
"[送花花]"	鼓励与肯定
新年那个，福禄满堂、	鼓励与肯定
别死，好好活着	建议与解决方案,鼓励与肯定
哇哦~这是哪位明星的见面会吗？	建议与解决方案
没有 [抱一抱]	情绪支持与共鸣
回复@柳卿卿卿卿:没事，经常这样疼就去看看 [抱抱]	建议与解决方案
再见吗？再 ～见！吧。	情绪支持与共鸣
听音乐叠星星，叠了一玻璃瓶了! [坏笑]	情感倾诉与交流
[打call]	鼓励与肯定
回复@咕噜噜-CN:不是的哦 我只是在这里扮演一个角色	负面回复
仙女妈咪 [舔屏]	鼓励与肯定
呜呜呜好吃	鼓励与肯定
我也在思考这个问题	情绪支持与共鸣
确实很美，不过跑步的时候要注意安全哦	建议与解决方案,鼓励与肯定
别自责 抱抱宝宝不要怪自己 [悲伤]	建议与解决方案
回复@活着是常态-死亡是奢望:难眠 [泪]	情绪支持与共鸣
第一次去 买到客场了怎么办 [泪]	建议与解决方案
宝宝我出有信誉着急补尾款不走pt可以吗白菜价	建议与解决方案
你好，你感兴趣的“勒沃库森”已开通了超话社区～ 超话社区是微博旗下兴趣互动社区，快来与志同道合的小伙伴们一起交流互动吧！ 戳我进入&gt;&gt; 勒沃库森[超话]	负面回复
出了吗宝子	建议与解决方案
加油小柳别气馁我一直支持你 [抱抱]	鼓励与肯定
加油加油，考差就考差，没关系的宝宝 [抱抱]	情绪支持与共鸣
抱抱老公我没有感同身受所以没法去说理解你，但是希望你可以越过越好 [抱抱]	情绪支持与共鸣,鼓励与肯定
美死啦～～～～～～	鼓励与肯定
真想抱住你 [抱抱]	情绪支持与共鸣
我28昨天16 [跪了]	情感倾诉与交流
哇哦，看起来你遇到了一个挑战！加油，我相信你可以克服它的！	鼓励与肯定
你是会zc吗抱抱宝宝 早日康复 [悲伤]	鼓励与肯定
好棒 [打call]	情绪支持与共鸣,鼓励与肯定
别让自己太沉重 [抱抱]	建议与解决方案
回复@不喜欢这个世界888:看来只有我是一直在抑郁	情感倾诉与交流
1 10	建议与解决方案
在哪订的冰箱贴，求个链接	建议与解决方案
那就请假休息调整调整	建议与解决方案
[悲伤]	情绪支持与共鸣
哈哈，初见美名，这头衔不错！咱们超话里见，一起聊聊原神棉花娃娃，老孙我也得去涨涨见识。	负面回复
晚安 [抱一抱]	情绪支持与共鸣
对，不能把自己憋坏了	情绪支持与共鸣
可是这世界本就不公平	负面回复
生日快乐，虽然你可能觉得有点奇怪，但记住，每一段关系都是一段旅程，都会让你成为今天的自己 [蛋糕]	鼓励与肯定
包扎了吗，这几天注意点尽量别碰水 [抱一抱]	建议与解决方案
两天都出	负面回复
[抱一抱]	情绪支持与共鸣
你分怎么这么高 [挖鼻]	鼓励与肯定
抱抱抱 [抱抱]	情绪支持与共鸣
回复@晚风晚风吹过来:你家长要是同意的话，我建议你可以去当专业生，因为我也是走的专业生/	建议与解决方案
同感啊 我妈也是	情绪支持与共鸣
抱 [抱抱]	情绪支持与共鸣
回复@P城流动摊贩-:所以…………同喜同喜 [坏笑]	情绪支持与共鸣
回复@Estrella__-:我在这里等你	情绪支持与共鸣
回复@心乱如麻辣鱼:那就把括号里面的部分删掉就好了，总之我的经验就是不要太去思考发病这件事啦，本人也停药两年了，偶尔发病但不影响生活啦，（前几天郁期刚过，现在处于躁期，但是该干啥干啥	情感倾诉与交流
自己尽力就好了	鼓励与肯定
不太懂，我感觉对发色，口红色号我是色盲	负面回复
没有人会讨厌你宝宝也不要怕别人不喜欢你 你本身已经够好啦 [抱抱]	鼓励与肯定
你好，你感兴趣的“微博渔场”已开通了超话社区～ 超话社区是微博旗下兴趣互动社区，快来与志同道合的小伙伴们一起交流互动吧！ 戳我进入&gt;&gt; 微博渔场[超话]	负面回复
还有1吗	建议与解决方案
是那种自己的意识与自己的身体暂时分离的状态吧…也许…	情绪支持与共鸣
天天开心呀	鼓励与肯定
喝点水 [抱抱]	情绪支持与共鸣,建议与解决方案
[抱一抱]	情绪支持与共鸣
你好，你感兴趣的“马陆”已开通了超话社区～ 超话社区是微博旗下兴趣互动社区，快来与志同道合的小伙伴们一起交流互动吧！ 戳我进入&gt;&gt; 马陆[超话]	负面回复
呜呜呜 [泪]	情绪支持与共鸣
真的好好看很喜欢这种氛围 [泪]	情绪支持与共鸣
注意身体宝宝 [哆啦A梦害怕]	建议与解决方案
哈哈，一起报复社会去 [good]	负面回复
早安 [兔子]	情绪支持与共鸣
好好看！！	鼓励与肯定
萌新都有的椅子我却没有 "[苦涩]"	情感倾诉与交流
可可爱爱 [鲜花]	鼓励与肯定
超赞 [抱抱]	鼓励与肯定
想当年我也是那个重度焦虑中度抑郁的人 [允悲]	情感倾诉与交流
哈哈哈哈哈	负面回复
天哪抱抱 [抱抱]	情绪支持与共鸣
哈哈，恭喜恭喜！LV.6可不是盖的，厉害厉害！原神棉花娃娃超话，你的名字已经响当当了！继续加油，期待你更耀眼的未来！	鼓励与肯定
但你要相信，每一个低谷都会过去，每一个困难都能克服，每一个明天都会更好	鼓励与肯定
这是什么东西 [跪了]	建议与解决方案
评论区都在骂她，没有人理解她的绝望。	情感倾诉与交流
哈哈 确实都很合适	鼓励与肯定
问问便利店	建议与解决方案
别哭别哭，我这里有一包纸巾	情绪支持与共鸣
怎么样啊	建议与解决方案
抱抱你，我们都有过那样的时刻，理解自己很重要 [心]	鼓励与肯定
甜甜哒晚安 [兔子]	情绪支持与共鸣
我现在胳膊就是这样	情绪支持与共鸣
哎我也是 [跪了]	情感倾诉与交流
晚安 [月亮]	情绪支持与共鸣
老婆蹲蹲教程	负面回复
女明星也要打工人的团建吗	建议与解决方案
主持，辛苦了 [给你小心心]	情绪支持与共鸣
回复@g寒故:早安 "[吹风车]"	情绪支持与共鸣
自己才是主体，不要时刻观察对方的反应就好了。别人都是NPC，都是为了让你开心的，这个不好用，就换另一个试试。	建议与解决方案
抱抱宝宝可以试试反击 [抱抱]	情绪支持与共鸣,建议与解决方案
遵医嘱吃没事	建议与解决方案
[抱抱]	情绪支持与共鸣
头疼怎么引起的呢	建议与解决方案
抱抱你，小猫咪也需要被理解和关心哦	建议与解决方案
极昼之间，遇见即是幸运，喜欢便是浪漫。周震南@VvvVvV周震南	负面回复
回复@一二与鹤:然后脱下来也花了半小时 [哈哈]	情感倾诉与交流
好漂亮啊 [哈哈]	鼓励与肯定
别哭了，我借你肩膀擦泪 [心]	情绪支持与共鸣
中午吃什么好	建议与解决方案
晚安 [月亮]	情绪支持与共鸣
[抱抱]	情绪支持与共鸣
"[锦鲤附体]"	鼓励与肯定
哇 这个场景真的好可爱	鼓励与肯定
蛐蛐回去 "[举手]"	建议与解决方案
摸摸 [鲜花]	鼓励与肯定
最近dy的都好慢	情绪支持与共鸣
"[锦鲤附体]"	鼓励与肯定
哇塞！好好看的格柄	鼓励与肯定
别想太多啦 爱你的人会一直在的 [抱抱]	建议与解决方案
早安 [兔子]	情绪支持与共鸣
不要这样想 [抱抱]	情绪支持与共鸣,建议与解决方案
我再也不会这样对你了 [泪]	情感倾诉与交流
半平台宝宝要看看嘛	建议与解决方案
晚上好 [兔子]	情绪支持与共鸣
哇 好厉害！恭喜恭喜	鼓励与肯定
问问妆容好漂亮啊 "[哇]"	鼓励与肯定
加油！你可以的 一定行	鼓励与肯定
要天天开心	建议与解决方案
[抱一抱]	情绪支持与共鸣
一起，路上有个伴	负面回复
[抱一抱]	情绪支持与共鸣
回复@P城流动摊贩-:看了价格 [允悲]	负面回复
我到现在也整不明白我为啥活着，毫无意义 [泪]	负面回复
[抱抱]	情绪支持与共鸣
哇塞 "[送花花]"	鼓励与肯定
咪这里新谷和三丽鸥在开953259239	建议与解决方案
抱抱 [抱抱]	情绪支持与共鸣
平胸也很好看啊	鼓励与肯定
早安宝宝 [抱一抱]	情绪支持与共鸣
加油 [给你小心心]	鼓励与肯定
青岛是不是可以实现海鲜自由了 [色]	情绪支持与共鸣
心疼你所经历的困扰，坚强如你，定能度过。记住，伤痕也是生命中的印记，它们让你更坚韧。望你早日找到缓解的法子，愿你平安喜乐。	鼓励与肯定
生老病死，不仅仅是人类的专利，自然界的一切生物（包括动，植物）也都遵循这一规律。	建议与解决方案
建议送去小英家历练一下	建议与解决方案
好用 "[老师爱你]"	鼓励与肯定
可以去追梦手幅定制这家问问，好像有做	建议与解决方案
同感啊！我也经常半夜被冻醒	情绪支持与共鸣
恭喜 "[送花花]"	鼓励与肯定
那就好开心一点 [抱抱]	情绪支持与共鸣
为什么不去了？明明在一个城市啊， "[流浪地球2]"	建议与解决方案
找机会，和心理老师聊聊	建议与解决方案
会好起来的	情绪支持与共鸣
早上好，宝宝	情绪支持与共鸣
是的 我们都要勇敢地说出我们的爱	建议与解决方案
别难过，你只是暂时迷失了自己，总有一天你会找到属于自己的光 [心]	鼓励与肯定
饱饱我抱抱你哇 要好好的 不要死哇 [抱抱]	情绪支持与共鸣
哈哈哈 看来这个小摊生意很好	鼓励与肯定
爱你 [馋嘴]	情绪支持与共鸣
亲，宝贝是不是有幻觉呀	建议与解决方案
回复@Raseannn:没有 家里都做好了饭 不能随便点外卖 准备周末去吃！！ [羞嗒嗒]	情感倾诉与交流
清冷美女	鼓励与肯定
姐妹还有位置吗	建议与解决方案
每天都这样呢 [允悲]	建议与解决方案
羡慕！度假也可以不耽搁盈利	鼓励与肯定
好好治疗 [抱抱]	情绪支持与共鸣,建议与解决方案
害怕什么？	建议与解决方案
[抱一抱]	情绪支持与共鸣
确实如此，有时候压力大了就会想要通过吃东西来缓解一下	情感倾诉与交流
[抱一抱]	情绪支持与共鸣
哇哦 好期待呢	情绪支持与共鸣
本痛苦开会的社畜刚偷偷摸摸点了一杯 "[融化]"	情感倾诉与交流
好棒?? 医生是怎么让你停药的 [泪]	建议与解决方案,鼓励与肯定
那时候一定有很多无法言喻的心事吧	情绪支持与共鸣
回复@板栗和清欢:希望这份工作能长久，虽然我在第一天就打了退堂鼓，不过还是鼓励自己多坚持。加油加油！！	鼓励与肯定
回复@树上的绿叶叶:可能吧 但是梦总是充满想象力的	情绪支持与共鸣
哇哦 好甜啊	鼓励与肯定
AmberAmberAmber（帅晕了，吸氧…继续……）AmberAmber [打call]	情绪支持与共鸣
肯定是喜欢吃的呀 [喵喵]	鼓励与肯定
我听见了 [哈哈]	情绪支持与共鸣
p7的花也太美了 [泪]	鼓励与肯定
回复@不爱吃鱼的王某某:自己意会吧 我就不说了	负面回复
我给你耗你还骂我 [微笑]	情感倾诉与交流
抱抱你宝宝[淚][淚]	情绪支持与共鸣
抱抱，怎么了呀 [抱抱]	情绪支持与共鸣
超话生快！	鼓励与肯定
[抱一抱]	情绪支持与共鸣
[抱一抱]	情绪支持与共鸣
那真是不错 [抱抱]	情绪支持与共鸣
回复@朱砂芝酱:小于500fo只能砖30条左右 大于500fo能砖1000左右（还要满足能瓶29条）	建议与解决方案
一天天说的就像全世界只要你在工作 [哈欠]	负面回复
好可爱哈哈哈哈 "[春游家族]"	鼓励与肯定
支持你 "[锦鲤附体]"	情绪支持与共鸣
俺老猪也为你高兴，原神棉花娃娃真不错，恭喜恭喜！	负面回复
变身魔法需要关注我哦！关注后再发一下试试哦～	建议与解决方案
回复@树上的绿叶叶:哈哈哈那一定是个满	负面回复
有点吓人 [傻眼]	情绪支持与共鸣
回复@被只许拿捏:我感觉有点哈哈	情绪支持与共鸣
未来是把握在自己手中的 [加油]	鼓励与肯定
[抱一抱]	情绪支持与共鸣
还是要睡觉的	建议与解决方案
六年秀粉归来还是秀粉的我	情感倾诉与交流
嘿！你也在关注“与凤行”吗？快戳网页链接进入专题页查看并关注相关博主吧，包含@邓科导演 、@九鹭非香 等24位博主哦，热门精彩内容不错过！	负面回复
[抱一抱]	情绪支持与共鸣
"[锦鲤附体]"	鼓励与肯定
愿家人平安，等待团聚时刻。	负面回复
兄弟，你这是心灵鸡汤大师啊 [赞]	鼓励与肯定
【赵丽颖与凤行】#赵丽颖沈璃# zly【赵丽颖沈璃】#赵丽颖与凤行# "[小凤凰]"	负面回复
[抱抱]	情绪支持与共鸣
侦探熊本熊前来报到 [喵喵]	情绪支持与共鸣
回复@想吃冰和火锅:啊啊我也不太清楚，我半途而废了可以确定好想做哪一类的多看看别人 "[苦涩]"	情感倾诉与交流
说得非常对！理性消费才是正确的消费观	鼓励与肯定
晚上好，宝宝 "[爱慕]"	情绪支持与共鸣
我是沙比 "[比耶]"	情绪支持与共鸣
后悔啥了？ [抱抱]	建议与解决方案
回复@芽芽今天好转了吗:我也喜欢户外运动 感觉特别放松	情感倾诉与交流
宝宝,抱图啦 "[开学季]"	情绪支持与共鸣
哇塞 "[爱慕]"	情绪支持与共鸣
那就继续吃药吧 生病不是你的错	建议与解决方案,鼓励与肯定
哎哟，这可真是令人头疼的一天呢不过，至少你还知道早点睡觉，这对身体可是大有裨益的呢希望你的头痛和拉肚子都能尽快好起来，以后记得注意饮食哦	情绪支持与共鸣,鼓励与肯定
期待夏天橘子汽水味的晚风 [抱一抱]	情绪支持与共鸣
愿我们和爱的人一起浪费人生，热泪盈眶?	鼓励与肯定
虞书欣 "[哇]"	情绪支持与共鸣
之前天天熬夜现在喝饮料都会睡 谢谢褪黑素	情感倾诉与交流
真的我也暴食，某团的月付都要被我刷爆了	情感倾诉与交流
说得对！我们不需要别人的认可和评价来定义自己的价值	鼓励与肯定
我把史铁生我与地坛这本书看完了，写的真的好	情绪支持与共鸣
看到你这个哈吉嘛笑死我了哈哈	情绪支持与共鸣
下午好呀	情绪支持与共鸣
辣条真的是我的最爱了不过也要适量食用哦 [馋嘴]	建议与解决方案,情感倾诉与交流
设置那里的视频画质拉最高？	建议与解决方案
我也是，我也是因为毕设不会写，加重焦虑，一夜夜失眠睡不着，别人都写完了，我却无从下手，整天担惊受怕 [泪]	情感倾诉与交流
中午好宝宝 [抱一抱]	情绪支持与共鸣
爱信等 "[汪洋海蓝比心]"	负面回复
是真的不能停（虽然我在停）双相之后我就停了，结果到现在凌晨四五点还失眠，比之前情况严重了很多 [允悲]	情感倾诉与交流
我也是 [泪]	情绪支持与共鸣
抱抱 [抱一抱]	情绪支持与共鸣
我也这样感觉身体越来越差了	情感倾诉与交流
一句你在哪是最好的安慰 [抱抱]	情绪支持与共鸣
顺利完赛 [打call]	鼓励与肯定
就是有病	情绪支持与共鸣
你已经做得很好了，不要害怕拒绝和寻求帮助	建议与解决方案,鼓励与肯定
回复@真的表现把自己微博博主:还挺好用的，长得像菜刀一样，你在购物网站上搜铺床神器，就出来了	建议与解决方案
没错！因为爱情所以日出	情绪支持与共鸣
俺老孙看了，这小子挺有干劲儿！	负面回复
意义是什么东西？	负面回复
[抱抱]	情绪支持与共鸣
您好可以请教你个问题么，我这不能私信 [泪]	建议与解决方案
哇 好运气爆棚啊	鼓励与肯定
朋友圈都是这样的，假的要死，已经关了1年多了	负面回复
这个最主要看你愿不愿意了我三年多了没做过一次心理咨询因为我很抗拒但宝宝如果你觉得可以接受不妨去试试 [抱抱]	建议与解决方案
没关系你就是最棒的宝宝！ [抱抱]	鼓励与肯定
这种情绪很正常，但请不要轻易放弃生命。如果你需要帮助，可以寻求专业心理咨询或者和朋友分享你的感受。生活虽然有时艰难，但总有美好在等待我们发现。	情绪支持与共鸣,鼓励与肯定
"[苦涩]"	情绪支持与共鸣
回复@若芽色深海:跟他们说话永远说不明白 每句话都冷嘲热讽的 有种就捅我?	负面回复
今晚的熬夜冠军是我哦	情感倾诉与交流
这个是什么针打头上的？	建议与解决方案
[抱抱]	情绪支持与共鸣
@Esther小鱼收藏册 打扰了	负面回复
百分制我都不及格 [拜拜]	情感倾诉与交流
回复@碎叶儿鸭:抱歉哦 小朋友 我最近有点忙	负面回复
抱抱抱 [抱抱]	情绪支持与共鸣
回复@浪漫绑架案:回关宝宝	建议与解决方案
睡吧睡吧	建议与解决方案
晚上好，宝宝 [抱一抱]	情绪支持与共鸣
我也 [兔子]	情绪支持与共鸣
希望我也能遇到自己的b姐吧 [泪]	情绪支持与共鸣
回复 @爱这悲惨世界:酸不酸啊宝 [抱一抱]	情绪支持与共鸣
回复@不爱吃鱼的王某某:51大神	负面回复
[抱抱]	情绪支持与共鸣
如果可以的话，你要不要买点褪黑素来吃一下。褪黑素，不是药，是那种有助眠功效的营养品。价格还算便宜的10块钱也能买不算小的一瓶。吃几片晚上睡得好。	建议与解决方案
回复@银河也睡着啦:别被淘汰了啊，下场感觉boa好猛 [泪]	情感倾诉与交流
祝你年年皆胜意，岁岁都欢愉！！！	负面回复
回复@g寒故:我也不想上学，天天被人搞东西 "[老师好]"	情感倾诉与交流
哇哦 好浪漫啊	鼓励与肯定
抱抱宝宝，怎么可以这样	情绪支持与共鸣
拼酒店吗？	建议与解决方案
吃了三个多月，会连续做梦和早醒	建议与解决方案
尖耳朵崽崽	负面回复
回复@P城流动摊贩-:手感不一样啊……… [doge]	建议与解决方案
我也是这样 可能是生物钟的原因	情绪支持与共鸣
我们都没错只是太痛苦了，想要提前回家了 [悲伤]	情绪支持与共鸣,情感倾诉与交流
是指盐酸舍曲林吗，不能叫它盐酸简称是舍曲林好一点 [允悲]	建议与解决方案
宝宝我也好喜欢你 "[送花花]"	鼓励与肯定
我们只能为自己负责！ [太开心]	情绪支持与共鸣
不愧是你 一发入魂 [doge]	鼓励与肯定
[抱一抱]	情绪支持与共鸣
好美 "[哇]"	鼓励与肯定
辛苦了 [抱抱]	情绪支持与共鸣
原来你也还没审核 [doge]	情绪支持与共鸣
你不是！ [抱一抱]	鼓励与肯定
建议，请不要太过于投入太多的感情，毕竟希望有多大，失望就有多大 [抱抱]	建议与解决方案
宝宝我也是[淚]我好自卑，我好希望得到爱	情感倾诉与交流
不是你的错，不要归咎于自身 [抱抱]	鼓励与肯定
糊就是菜最好的保护色 [汗]	情绪支持与共鸣
跟医生沟通换药？我目前吃的氟西汀，医生只给我加量不给换药，怕我长胖更严重 "[揣手]"	建议与解决方案,情感倾诉与交流
回复@左一口ang:另一组	负面回复
加油！你很棒	鼓励与肯定
你不论变成什么样子，都要去勇于接受自己，如果不满意并努力去改正。	建议与解决方案
我蹲 [偷笑]	负面回复
是不是年龄大了，寿命到了？	建议与解决方案
每天都在想死	情感倾诉与交流
我也在一边寻找一边治愈，但是找了很久都没有找到合适的工作。所以现在开始先写小说了，这是我唯一的爱好，不指望它吃饭，但我想慢慢做好。以后我看见你的微博的话我也会给你分享我的一些事情，如果你不介意的话我真的希望我们一起慢慢好起来。 [嘻嘻]	情绪支持与共鸣,情感倾诉与交流,鼓励与肯定
变身魔法需要关注我哦！关注后再发一下试试哦～	负面回复
梦醒时分，一切都会好的	鼓励与肯定
"[举手]"	建议与解决方案
好米 [好爱哦]	鼓励与肯定
能开心就好	鼓励与肯定
亲爱的，你并不孤单，我会一直在你身边	情绪支持与共鸣
小橘猫呀	负面回复
心痛是暂时的，但回忆是永恒的 [心]	情感倾诉与交流
我29号 [裂开]	建议与解决方案
那你们一定都是最棒的 [鼓掌]	情绪支持与共鸣,鼓励与肯定
淇淇 [心]	情绪支持与共鸣
你已经很棒啦 [抱抱]	情绪支持与共鸣,鼓励与肯定
加油，不要小看了自己身上的火之意志！妈的燃起来了	鼓励与肯定
只要开播，我心情就好了	情感倾诉与交流
对，还有妈妈 [抱抱]	情绪支持与共鸣
去看医生吧 [抱抱]	建议与解决方案
恭喜恭喜！真的很棒呢	鼓励与肯定
回复@心乱如麻辣鱼:不可能的	鼓励与肯定
[抱抱]	情绪支持与共鸣
早安宝宝 [抱一抱]	情绪支持与共鸣
